220,-50,180,350,30,-1;		180,350,100,400,10,-1;		100,400,-100,450,10,-1;;;
150,-50,200,350,25,1;		200,350,200,350,85,0;		200,350,-100,450,25,-1;;;
-50,450,150,350,30,1;		150,350,200,250,25,1;		200,250,170,-100,60,-1;;;
-50,450,150,420,15,1;		150,420,330,320,15,1;		330,320,530,290,15,1;;;
-50,450,150,420,30,1;		150,420,330,320,30,1;		330,320,530,290,30,1;;;
50,-100,50,900,1000,0;;;
-100,450,100,400,10,1;		100,400,180,350,10,1;		180,350,220,-50,30,1;;;
-100,200,580,250,140,1;;;





//  <-- Trennzeichen für den Code

Weg der Gegner
x_start, y_start, x_end, y_end, Frames, ModelArt [-1 = left] [0 = normal] [1 = right]

Es wird immer der komplette Weg in ein Listenelement geladen und dann komplett abgefragt