 180,0,160,380,30,-1;  160,380,140,400,5,-1;  140,400,120,380,5,-1;  120,380,120,340,5,0;  120,340,140,320,5,1;  140,320,160,320,5,1;  160,320,530,400,25,1;;;
 25,0,25,300,15,0;  25,300,25,400,15,0;  25,400,25,500,20,0;  25,500,25,600,25,0;  25,600,25,700,30,0;  25,700,25,800,35,0;  25,800,25,850,20,0;;;
 150,300,150,300,5,-1;  150,300,150,300,5,0;  150,300,150,300,20,1;   150,300,125,300,10,1;  125,300,100,275,10,1;  100,275,100,250,10,1;  100,250,125,225,10,1;  125,225,150,225,10,1;  150,225,175,250,10,1;  175,250,175,275,10,1;  175,275,150,300,10,1;  150,300,125,300,10,1;  125,300,100,275,10,1;  100,275,100,250,10,1;  100,250,125,225,10,1;  125,225,150,225,10,1;  150,225,175,250,10,1;  175,250,175,275,10,1;  175,275,150,300,10,1;  150,300,150,300,20,1;  150,300,150,300,5,0;  150,300,150,300,5,-1;;;
 25,0,50,25,5,1;  50,25,25,50,5,-1;  25,50,50,75,5,1;  50,75,25,100,5,-1;  25,100,50,125,5,1;  50,125,25,150,5,-1;  25,150,50,150,5,1;  50,150,25,175,5,-1;  25,175,50,200,5,1;  50,200,25,225,5,1;  25,225,50,250,5,-1;  50,250,25,275,5,-1;  25,275,50,300,5,1;  50,300,25,325,5,-1;  25,325,50,350,5,1;  50,350,25,375,5,-1;  25,375,50,400,5,1;  50,400,25,425,5,-1;  25,425,50,450,5,1;  50,450,25,475,5,-1;  25,475,50,500,5,1;  50,500,25,525,5,-1;  25,525,50,550,5,1;  50,550,25,575,5,-1;  25,575,50,600,5,1;  50,600,25,625,5,-1;  25,625,50,650,5,1;  50,650,25,675,5,-1;  25,675,50,700,5,1;  50,700,25,725,5,-1;  25,725,50,750,5,1;  50,750,25,775,5,-1;  25,775,50,800,5,1;  50,800,25,825,5,-1;  25,825,50,850,5,1;;;
 -50,300,430,300,20,-1;  430,300,50,300,50,1;  50,300,430,300,50,-1;  430,300,50,300,20,1;;;
 -50,250,320,400,40,0;  320,400,430,300,20,0;  430,300,160,200,30,0;  160,200,50,300,20,0;  50,300,530,250,40,0;;;
 -50,400,240,400,5,0;  240,400,240,400,10,0;;;
 240,400,200,440,10,0;  200,440,160,440,10,0;  160,440,120,400,10,0;  120,400,120,360,10,0;  120,360,160,320,10,0;  160,320,200,320,10,0;  200,320,240,360,10,0;  240,360,240,400,10,0;          240,400,280,440,10,0;  280,440,320,440,10,0;  320,440,360,400,10,0;  360,400,360,360,10,0;  360,360,320,320,10,0;  320,320,280,320,10,0;  280,320,240,360,10,0;  240,360,240,400,10,0;          240,400,240,400,20,0;          240,400,200,440,10,0;  200,440,160,440,10,0;  160,440,120,400,10,0;  120,400,120,360,10,0;  120,360,160,320,10,0;  160,320,200,320,10,0;  200,320,240,360,10,0;  240,360,240,400,10,0;          240,400,280,440,10,0;  280,440,320,440,10,0;  320,440,360,400,10,0;  360,400,360,360,10,0;  360,360,320,320,10,0;  320,320,280,320,10,0;  280,320,240,360,10,0;  240,360,240,400,10,0;          240,400,240,400,20,0;          240,400,200,440,10,0;  200,440,160,440,10,0;  160,440,120,400,10,0;  120,400,120,360,10,0;  120,360,160,320,10,0;  160,320,200,320,10,0;  200,320,240,360,10,0;  240,360,240,400,10,0;          240,400,280,440,10,0;  280,440,320,440,10,0;  320,440,360,400,10,0;  360,400,360,360,10,0;  360,360,320,320,10,0;  320,320,280,320,10,0;  280,320,240,360,10,0;  240,360,240,400,10,0;          240,400,240,400,20,0;          240,400,200,440,10,0;  200,440,160,440,10,0;  160,440,120,400,10,0;  120,400,120,360,10,0;  120,360,160,320,10,0;  160,320,200,320,10,0;  200,320,240,360,10,0;  240,360,240,400,10,0;          240,400,280,440,10,0;  280,440,320,440,10,0;  320,440,360,400,10,0;  360,400,360,360,10,0;  360,360,320,320,10,0;  320,320,280,320,10,0;  280,320,240,360,10,0;  240,360,240,400,10,0;          240,400,240,400,20,0;          240,400,200,440,10,0;  200,440,160,440,10,0;  160,440,120,400,10,0;  120,400,120,360,10,0;  120,360,160,320,10,0;  160,320,200,320,10,0;  200,320,240,360,10,0;  240,360,240,400,10,0;          240,400,280,440,10,0;  280,440,320,440,10,0;  320,440,360,400,10,0;  360,400,360,360,10,0;  360,360,320,320,10,0;  320,320,280,320,10,0;  280,320,240,360,10,0;  240,360,240,400,10,0;          240,400,240,400,20,0;          240,400,200,440,10,0;  200,440,160,440,10,0;  160,440,120,400,10,0;  120,400,120,360,10,0;  120,360,160,320,10,0;  160,320,200,320,10,0;  200,320,240,360,10,0;  240,360,240,400,10,0;          240,400,280,440,10,0;  280,440,320,440,10,0;  320,440,360,400,10,0;  360,400,360,360,10,0;  360,360,320,320,10,0;  320,320,280,320,10,0;  280,320,240,360,10,0;  240,360,240,400,10,0;          240,400,240,400,20,0;          240,400,240,-50,40,0;;;





//  <-- Trennzeichen für den Code

Weg der Gegner
x_start, y_start, x_end, y_end, Frames, ModelArt [-1 = left] [0 = normal] [1 = right]

Es wird immer der komplette Weg in ein Listenelement geladen und dann komplett abgefragt