-50,150,360,250,50,1;  360,250,80,350,30,-1;  80,350,360,450,30,1;  360,450,-50,550,50,-1;;;
-100,150,240,200,40,1;  240,200,80,250,80,-1;  80,250,-100,200,30,-1;;;
-50,150,180,180,20,1;  180,180,200,200,5,1;  200,200,200,220,5,0;  200,220,180,240,5,-1;  180,240,160,240,5,-1;  160,240,140,220,5,-1;  140,220,140,200,5,0;  140,200,160,180,5,1;  160,180,240,200,20,1;       240,200,260,220,5,1;  260,220,260,240,5,0;  260,240,240,260,5,-1;  240,260,220,260,5,-1;  220,260,200,240,5,-1;  200,240,200,220,5,0;  200,220,220,200,5,1;  220,200,300,220,20,1;        300,220,320,240,5,1;  320,240,320,260,5,0;  320,260,300,280,5,-1;  300,280,280,280,5,-1;  280,280,260,260,5,-1;  260,260,260,240,5,0;  260,240,280,220,5,1;  280,220,500,260,60,1;;;
-50,150,220,180,30,1;  220,180,240,200,5,1;  240,200,240,220,5,0;	240,220,220,240,5,-1;  220,240,200,240,5,-1;  200,240,180,260,5,-1;  180,260,180,280,5,0;  180,280,200,300,5,1;  200,300,220,300,5,1;  220,300,240,280,5,1;  240,280,240,260,5,0;  240,260,260,240,5,1;  260,240,280,240,5,1;  280,240,530,260,30,1;;;
240,-50,240,900,800,0;;;
-50,0,150,50,15,1;  150,50,50,100,15,-1;  50,100,150,150,15,1;  150,150,50,200,15,-1;  50,200,150,250,15,1;  150,250,50,300,15,-1;  50,300,150,350,15,1;  150,350,50,400,15,-1;  50,400,150,450,15,1;  150,450,50,500,15,-1;  50,500,150,550,15,1;  150,550,50,600,15,-1;  50,600,150,650,15,1;  150,650,50,700,15,-1;  50,700,150,750,15,1;  150,750,50,800,15,-1;  50,800,150,850,15,1;  150,850,50,900,15,-1;;;





//  <-- Trennzeichen für den Code

Weg der Gegner
x_start, y_start, x_end, y_end, Frames, ModelArt [-1 = left] [0 = normal] [1 = right]

Es wird immer der komplette Weg in ein Listenelement geladen und dann komplett abgefragt