-50,400,50,350,15,1;  50,350,80,200,20,1;  80,200,100,200,5,1; 100,200,130,420,20,1;  130,420,150,420,5,1;  150,420,200,0,80,1;;;
180,-50,220,250,15,-1;  220,250,220,250,30,0;  220,250,50,200,10,-1;  50,200,50,200,30,0;  50,200,175,270,10,1;  175,270,175,270,30,0;  175,270,100,225,10,-1;  100,225,100,225,30,0;  100,225,140,-50,15,1;;;
240,-50,240,250,30,0;  240,250,260,250,15,1;  260,250,300,290,15,1;  300,290,300,330,15,0;  300,330,260,370,15,-1;  260,370,220,370,15,-1;  220,370,180,330,15,-1;  180,330,180,290,15,0;  180,290,220,250,15,1;  220,250,260,250,15,1;      260,250,300,290,15,1;  300,290,300,330,15,0;  300,330,260,370,15,-1;  260,370,220,370,15,-1;  220,370,180,330,15,-1;  180,330,180,290,15,0;  180,290,220,250,15,1;  220,250,260,250,15,1;      260,250,300,290,15,1;  300,290,300,330,15,0;  300,330,260,370,15,-1;  260,370,220,370,15,-1;  220,370,180,330,15,-1;  180,330,180,290,15,0;  180,290,220,250,15,1;  220,250,260,250,15,1;      260,250,300,290,15,1;  300,290,300,330,15,0;  300,330,260,370,15,-1;  260,370,220,370,15,-1;  220,370,180,330,15,-1;  180,330,180,290,15,0;  180,290,220,250,15,1;  220,250,240,250,15,1;      240,250,240,-50,30,0;;;
240,-50,240,400,20,0;  240,400,260,420,10,1;  260,420,280,420,10,1;  280,420,730,320,90,1;;;
480,0,400,450,40,0;  400,450,200,250,30,0;  200,250,150,380,30,0;  150,380,50,180,30,0;  50,180,-50,420,30,0;;;
-50,450,100,300,30,0;  100,300,180,480,30,0;  180,480,300,220,30,0;  300,220,400,400,30,0;  400,400,530,100,30,0;;;
-50,200,150,380,40,0;  150,380,180,180,30,0;  180,180,320,420,30,0;  320,420,420,280,30,0;  420,280,530,500,30,0;;;



//  <-- Trennzeichen für den Code

Weg der Gegner
x_start, y_start, x_end, y_end, Frames, ModelArt [-1 = left] [0 = normal] [1 = right]

Es wird immer der komplette Weg in ein Listenelement geladen und dann komplett abgefragt